##############
# H #  ####  #
#1####  ##  #
#121#  ##  #
###1# ##  #
#  2133  #
#########
